{
  "0": 1,
  "1": 20,
  "2": 40,
  "3": 76,
  "4": 85,
  "5": 105
}
